###########
#.. ... ..#
# # ### # #
+   ...
#.# ### #.#
#.# .o. #.#
#.# ### #.#
    ...   +
# # ### # #
#.. ... .g#
###########
